1111111111111111111
11000000C00010C0011
10010111110C0001111
10010000C0000P00011
1001000000000E01111
100C0000101100000C1
1111111111111111111