1111111111111
10C100C0000C1
1C00011111001
100P11E0000C1
1111111111111