111111111111111111111111111111111111111111111111111111111
100000000000000C00000C0000000000000000000000000000000C001
1P10010100100E001010010C0000C101C0000C000000000C000000001
1010010010101010001001000000010100000C0000C00000000000001
100000000C00C0000000000C00000000C000000000C0000C0000C00C1
111111111111111111111111111111111111111111111111111111111